22222222222222222222-
22222222222222222222-
22222220000002222222-
22222220222202222222-
00000000222200000000-
22222222222222222222-
22222222222222222222-
22222222222222222222-
22222222222222222222