22222222222222222222-
22222222222222222222-
22000002222000000222-
22022202222022220222-
00022202222022220000-
22222202222022222222-
22222200000022222222-
22222222222222222222-
22222222222222222222