22222222222222222222-
22222220000000022222-
22222220000000022222-
22222220022220022222-
00000000022220000000-
00000000022220000000-
22222220022220022222-
22222220000000022222-
22222220000000022222-
22222222222222222222